Kata benda:

acetaminofen	a se ta mi no fen
ahmad	ah mad
air	a ir
aja	a ja
alergi	a ler gi
alkohol	al ko ho l
angka	a ng ka
antidepressan	an ti de pre san
anu	a nu
apel	a pel
apotek	a po te k
arteri	ar te ri
awal	a wa l
ayah	a yah
badan	ba da n
bagian	ba gi an
balik	ba li k
bapak	ba pak
batuk	ba tu k
belakangan	be la ka ng an
berpengaruh	ber pe ng a ruh
bius	bi us
bu	bu
buah	bu ah
bulan	bu la n
celcius	sel si us
ct	si ti
dada	da da
darah	da rah
darahnya	da rah nya
depan	de pa n
derajat	de ra ja t
dok	dok
dokter	dok ter
garam	ga ra m
gastritis	gas tri tis
jantung	ja n tu ng
wajah	wa ja h
sendi	se n di
pisang	pi sa ng
pepaya	pe pa ya
orang	o ra ng
otot	o tot
obatan	o ba ta n
obat	o ba t
minuman	mi nu ma n
minyak	mi nya k
kayu	ka yu
obatnya	o ba t nya
dua	du a
tujuh	tu juh
tiga	ti ga
sepuluh	se pu lu h
sayuran	sa yu ra n
sayurannya	sa yu ra n nya
lima	li ma
kepala	ke pa la
jam	ja m
kaki	ka ki
donor	do no r
enam	e na m
dulu	du lu
empat	em pa t
flu	flu
form	for m
gejala	ge ja la
gejalanya	ge ja l a nya
gelas	ge la s
hari	ha ri
hijau	hi ja u
hal	hal
ibu	i bu
ibuprofen	i bu pro fen
insomnia	in so m ni a
jantungnya	ja n tu ng nya
kanan	ka na n
kasih	ka si h
keluarga	ke lu ar ga
keluhan	ke lu ha n
keluhannya	ke lu ha n nya
kemarin	ke ma ri n
kiri	ki ri
koma	ko ma
kopi	ko pi
layar	la ya r
list	lis t
kesehatan	ke se ha ta n
lambung	la m bu ng
lukanya	lu ka nya
lokal	lo kal
makanan	ma ka na n
maksudnya	mak sud nya
malam	ma la m
malem	ma le m
masalah	ma sa la h
merah	me ra h
mimpi	mi m pi
minggu	mi ng gu
misal	mi sal
nafsu	naf su
nanti	na n ti
natural	na tu ral
normal	nor mal
penyakit	pe nya kit
ubin	u bi n
tenggorokan	te ng go ro ka n
sembilan	se m bi lan
rumah	ru mah
punggung	pu ng gu ng
pernafasan	per na fa sa n
perut	pe ru t
perutnya	pe rut nya
putih	pu tih
ototmu	o tot mu
paracetamol	pa ra ce ta mol
pak	pak
pagi	pa gi
pandangan	pa n da ng an
pandangannya	pa n da ng an nya
pedas	pe das
penglihatanmu	pe ng li ha ta n mu
pereda	pe re da
pilek	pi lek
posisinya	po si si nya
rasa	ra sa
rasanya	ra sa nya
riwayat	ri wa yat
satu	sa tu
sebentar	se ben tar
sehari	se ha ri
seharian	se ha ri an
sekitar	se ki ta r
semisal	se mi sal
serangan	se ra ng an
sma	s em a
stroke	s tro k
sudah	su dah
suhu	su hu
tanda	ta n da
terakhir	te rak hir
tulisin	tu li si n
umur	u mur
waktu	wak tu

Kata kerja:

ada	a da
bangun	ba ng un
bantu	ba n tu
berminyak	ber mi nya k
biasanya	bi a sa nya
bilang	bi la ng
bisa	bi sa
boleh	bo leh
buat	bu at
cari	ca ri
cek	cek
cepat	ce pat
coba	co ba
diambil	di a m bi l
diminum	di mi nu m
diperjelas	di per je la s
ditusuk	di tu su k
masuk	ma suk
mau	ma u
duduk	du du k
istirahat	is ti ra ha t
jalan	ja la n
kurangi	ku ra ng i
melemaskan	me le mas ka n
membantu	me m ban tu
tambah	ta m bah
tanya	ta nya
gatau	ga ta u
gerak	ge ra k
gini	gi ni
gitu	gi tu
habis	ha bis
ikut	i ku t
ilang	i la ng
isi	i si
jadi	ja di
jahit	ja hit
jangan	ja ng an
kebangun	ke ba ng un
kejadian	ke ja di an
keliatan	ke li a ta n
kelihatannya	ke li ha ta n nya
kepecah	ke pe ca h
kerasa	ke ra sa
kerasanya	ke ra sa nya
kerja	ker ja
kesini	ke si ni
kurang	ku ra ng
pijat	pi ja t
periksa	pe rik sa
ngerokok	nge ro kok
ngurangin	ng u ra ng in
minum	mi nu m
langsung	la ng su ng
makan	ma kan
lembur	le m bur
menurun	me nu ru n
merasa	me ra sa
muncul	mu n cul
naik	na ik
ntar	n tar
nyangkut	nya ng kut
paling	pa li ng
parah	pa ra h
pecah	pe cah
perbanyak	per ba nyak
perhatian	per ha ti an
rebahan	re ba han
rileks	ri leks
scan	se ken
saran	sa ra n
sarankan	sa ran kan
sarannya	sa ran nya
pulang	pu la ng
pusing	pu si ng
rada	ra da
sampai	sa m pa i
sembuh	se m bu h
sembuhnya	se m buh nya
sempat	se m pa t
sempet	se m pet
setahu	se ta hu
silahkan	si lah ka n
silakan	si la kan
sini	si ni
situ	si tu
tahu	ta hu
tertusuk	ter tu su k
terus	te ru s
tidur	ti du r
tidurnya	ti dur nya
tolong	to lo ng
terapi	te ra pi
terasa	te ra sa
terima	te ri ma
turun	tu ru n
tusuk	tu su k



kata sifat:

akan	a ka n
aneh	a neh
bagus	ba gu s
baik	ba ik
banyak	ba nyak
bengkak	be ng kak
berat	be ra t
biasa	bi a sa
burem	bu re m
capek	a pek
cukup	cu ku p
cuma	cu ma
demam	de ma m
enak	e nak
gaenak	ga e nak
hangat	ha ng at
jarang	ja ra ng
juga	ju ga
kadang	ka da ng
kaya	ka ya
kayanya	ka ya nya
kemungkinan	ke mu ng ki na n
kenyang	ke nya ng
kesumbat	ke su m ba t
kram	ke ram
mual	mu al
lagi	la gi
lain	la i n
lama	la ma
laper	la per
lebih	le bi h
lekas	le kas
lemes	le me s
malah	ma lah
masih	ma sih
muda	mu da
mungkin	mu ng ki n
ngga	ng ga
nyeri	nye ri
pembengkakan	pe m be ng ka ka n
pembengkakannya	pe m be ng ka ka n nya
penuh	pe nu h
perih	pe ri h
sakit	sa kit
sakitnya	sa kit nya
pernah	per nah
perihnya	pe rih nya
perlu	per lu
sadarnya	sa dar nya
saja	sa ja
salah	sa la h
sama	sa ma
sebelum	se be lu m
sebelumnya	se be lu m nya
sebenernya	s e b e n e r nya
sedikit	se di ki t
segera	se ge ra
sejauh	se ja uh
sekali	se ka li
selama	se la ma
selamat	se la mat
semoga	se mo ga
senang	se na ng
sendiri	sen di ri
sering	se ri ng
seringnya	se ri ng nya
sesering	se se ri ng
sulit	su li t
susah	su sa h
tegak	te gak
tegang	te ga ng
tepat	te pa t
tinggi	ti ng gi
terlalu	ter la lu
tertentu	ter te n tu
tiap	ti a p
tua	tu a
udah	u da h
umum	u mu m
untung	un tu ng
wajar	wa ja r



kata ganti/tanya/tunjuk/sambung/keterangan

balurin	ba lu ri n
apa	a pa
apakah	a pa kah
apalagi	a pa la gi
atau	a ta u
berapa	be ra pa
biar	bi ar
dan	dan
dari	da ri
di	di
deh	deh
doang	do a ng
eeh	eeh
eh	eh
em	m
gimana	gi ma na
hai	ha i
halo	ha lo
ini	i ni
itu	i tu
iya	i ya
kah	kah
kalau	ka la u
kalo	ka lo
kapan	ka pa n
karena	ka re na
ke	ke
kenapa	ke na pa
mana	ma na
nih	nih
ok	o ke
oke	o ke
sambil	sa m bil
secara	se ca ra
sejak	se ja k
selain	se la in
sepertinya	se per ti nya
tapi	ta pi
sih	sih
tentang	ten ta ng
untuk	un tuk
ya	ya
yang	ya ng



kata subyek :

kamu	ka mu
kita	ki ta
saya	sa ya



kata numerik:

beberapa	be be ra pa
seberapa	se be ra pa
secangkir	se ca ng ki r
sejam	se ja m
seminggu	se mi ng gu
semua	se mu a
